11111111111111
10C10000000C11
10000111110011
1P0011E0000001
11111111111111